NO                 ./textures/colorstone.xpm
SO   ./textures/greystone.xpm

WE     ./textures/bluestone.xpm
EA   ./textures/wood.xpm

F    255  ,  248  ,  220




C 125   ,206,  101

111111
100011
100001
1S0001
111111