        NO                 ./textures/knee.xpm   
  SO   ./textures/knee.xpm

  WE     ./textures/knee.xpm
   EA   ./textures/knee.xpm

       F    251  ,  248  ,  220   



    C      251  ,  248  ,  220     


111111     
 100011
100001     
1S0001
111111  
