        NO                 ./textures/knee.xpm   
  SO   ./textures/knee.xpm

  WE     ./textures/knee.xpm
   EA   ./textures/knee.xpm

       C    56  ,  56  ,  56   



    F      112  ,  112  ,  112     

 111111111111
 11111101001
 111011S0011111
 10000001111
 10111011
 10011001111111
 11111111
 111 1111
  11111111
