        NO                 ./textures/knee.xpm   
  SO   ./textures/knee.xpm

  WE     ./textures/knee.xpm
   EA   ./textures/knee.xpm

       F    251  ,  248  ,  220   



    C      251  ,  248  ,  220     


11111111111111111111111111
1000000000110000000000001
1011000001110000000000001                    
10010000000000000000000011
111111111011000001110000011111111 
    100000000011000001110111111111111  
11110111111111011100000010001
1111011111111101 101010010001   
11000000110101011100000010001
10000000000000001100000010001
10000000000000001101010010001
11000001110101011111011010S111
1111011111101011011110100011
111111111111111111111111111
